28	39	37	26	24	27	32	36	28	28	33	37	27	36	36	43	19	27	29	25	30	29	30	42	33	32	43	25	34	42	35	47	39	28	34	34	34	26	36	27	26	31	40	31	18	23	32	19	31	22	27	30	22	21	27	36	28	37	30	27	24	36	32	41	31	25	33	26	28	33	27	37	29	29	28	41	40	37	30	26	38	28	26	36	31	32	33	36	35	28	34	23	27	34	29	34	28	38	27	34
21	18	19	23	16	34	23	21	19	23	20	19	28	26	24	19	18	15	18	20	17	25	32	32	30	28	27	28	21	23	31	28	29	21	22	27	22	29	15	16	18	15	15	12	11	20	28	17	21	16	19	24	28	17	16	14	26	32	24	21	12	17	21	22	26	19	20	25	29	21	24	18	18	22	27	25	25	33	16	22	24	9	28	20	23	24	16	28	27	29	20	16	16	19	21	24	24	32	23	16
0	0	0	0	0	0	0	0	0	0	0	0	0	0	0	0	0	0	0	0	0	0	0	0	0	0	0	0	0	0	0	0	0	0	0	0	0	0	0	0	0	0	0	0	0	0	0	0	0	0	0	0	0	0	0	0	0	0	0	0	0	0	0	0	0	0	0	0	0	0	0	0	0	0	0	0	0	0	0	0	0	0	0	0	0	0	0	0	0	0	0	0	0	0	0	0	0	0	0	0
62	57	55	59	56	57	61	60	56	53	58	58	59	50	59	57	54	64	57	51	68	56	44	45	60	41	44	53	55	55	59	57	48	43	57	55	49	69	55	64	56	57	57	62	73	57	51	67	64	56	56	64	58	61	64	50	64	45	58	55	63	47	48	72	51	63	63	46	52	55	58	59	71	47	51	52	66	47	62	42	73	59	55	55	58	56	60	56	59	52	61	69	50	66	56	60	51	53	59	58
9	8	9	16	10	12	9	10	6	10	9	9	8	5	13	7	13	13	10	9	16	13	11	6	16	8	12	9	8	10	11	4	9	13	11	7	8	11	9	8	10	11	9	6	11	14	8	12	7	11	12	12	5	11	11	9	8	7	8	14	11	7	12	9	8	10	11	5	9	13	9	7	10	10	4	8	8	8	10	8	14	8	7	12	7	11	8	11	8	8	13	12	8	9	10	5	8	8	8	12
