14	14	24	29	20	15	11	21	18	12	24	20	19	17	20	17	19	11	18	17	17	11	20	12	24	17	11	19	12	17	14	19	12	12	27	17	19	21	17	19	23	17	11	13	14	27	20	19	18	17	27	14	25	20	19	21	20	13	18	17	12	14	15	17	21	31	20	22	29	14	20	19	13	25	12	14	19	33	11	22	28	20	15	17	23	16	11	8	16	14	8	7	14	13	18	12	18	18	22	12
12	21	18	27	26	15	16	13	13	17	23	30	23	9	15	21	14	11	20	20	24	15	17	14	15	22	12	8	17	13	13	12	14	20	16	18	19	22	9	17	16	36	8	12	16	19	17	29	18	15	19	14	20	21	20	15	23	27	19	13	12	13	14	17	28	24	18	24	19	19	24	16	16	19	11	14	14	23	27	24	25	19	24	23	15	10	10	14	17	13	12	10	17	19	14	11	12	19	16	15
0	0	0	0	0	0	0	0	0	0	0	0	0	0	0	0	0	0	0	0	0	0	0	0	0	0	0	0	0	0	0	0	0	0	0	0	0	0	0	0	0	0	0	0	0	0	0	0	0	0	0	0	0	0	0	0	0	0	0	0	0	0	0	0	0	0	0	0	0	0	0	0	0	0	0	0	0	0	0	0	0	0	0	0	0	0	0	0	0	0	0	0	0	0	0	0	0	0	0	0
83	78	87	61	80	77	75	92	79	84	65	76	88	100	58	90	72	77	79	84	74	98	78	75	76	76	101	87	69	95	78	74	99	76	85	83	82	63	78	92	74	74	84	79	85	74	88	71	78	73	78	75	80	79	74	69	79	91	68	82	97	86	71	84	72	74	73	79	76	77	80	83	71	77	100	88	59	83	78	75	73	82	79	74	75	85	93	82	86	85	77	86	79	84	89	85	81	77	82	88
0	0	0	0	0	0	0	0	0	0	0	0	0	0	0	0	0	0	0	0	0	0	0	0	0	0	0	0	0	0	0	0	0	0	0	0	0	0	0	0	0	0	0	0	0	0	0	0	0	0	0	0	0	0	0	0	0	0	0	0	0	0	0	0	0	0	0	0	0	0	0	0	0	0	0	0	0	0	0	0	0	0	0	0	0	0	0	0	0	0	0	0	0	0	0	0	0	0	0	0
