72	83	99	92	93	114	87	94	112	96	84	86	99	92	99	89	101	99	96	89	99	98	103	88	95	97	94	100	88	82	109	91	89	100	99	100	91	99	94	89	101	93	96	100	87	94	105	85	101	92	93	105	99	87	133	82	95	79	86	109	95	85	94	95	94	98	97	88	97	98	75	92	105	87	104	89	85	89	117	97	94	101	82	102	100	87	99	81	91	80	107	90	94	87	82	96	94	83	102	86
87	94	108	98	82	96	100	78	117	102	103	67	95	112	81	99	97	103	96	110	88	98	77	108	93	88	109	97	82	103	104	91	94	93	95	93	104	94	93	111	78	102	108	97	103	99	85	97	87	102	105	83	100	89	95	93	104	111	90	97	101	105	99	82	92	101	99	96	76	96	109	94	97	83	95	78	116	93	95	100	89	103	84	99	92	91	122	92	80	94	96	86	107	88	96	102	95	101	97	94
0	0	0	0	0	0	0	0	0	0	0	0	0	0	0	0	0	0	0	0	0	0	0	0	0	0	0	0	0	0	0	0	0	0	0	0	0	0	0	0	0	0	0	0	0	0	0	0	0	0	0	0	0	0	0	0	0	0	0	0	0	0	0	0	0	0	0	0	0	0	0	0	0	0	0	0	0	0	0	0	0	0	0	0	0	0	0	0	0	0	0	0	0	0	0	0	0	0	0	0
0	0	0	0	0	0	0	0	0	0	0	0	0	0	0	0	0	0	0	0	0	0	0	0	0	0	0	0	0	0	0	0	0	0	0	0	0	0	0	0	0	0	0	0	0	0	0	0	0	0	0	0	0	0	0	0	0	0	0	0	0	0	0	0	0	0	0	0	0	0	0	0	0	0	0	0	0	0	0	0	0	0	0	0	0	0	0	0	0	0	0	0	0	0	0	0	0	0	0	0
9	11	12	8	7	0	0	0	0	0	0	0	0	0	0	0	0	0	0	0	0	0	0	0	0	0	0	0	0	0	0	0	0	0	0	0	0	0	0	0	0	0	0	0	0	0	0	0	0	0	0	0	0	0	0	0	0	0	0	0	0	0	0	0	0	0	0	0	0	0	0	0	0	0	0	0	0	0	0	0	0	0	0	0	0	0	0	0	0	0	0	3	6	9	3	6	8	10	6	6
