54	63	74	87	73	77	70	61	54	61	60	45	54	56	58	62	35	53	53	62	64	70	53	67	71	63	59	68	62	59	63	51	53	52	57	81	75	62	62	68	87	76	66	70	57	53	58	85	68	71	71	82	86	65	67	50	55	50	64	55	80	51	72	64	87	70	63	70	89	96	75	76	46	81	61	75	70	63	64	71	58	53	65	74	80	81	84	87	81	66	73	64	89	65	66	84	71	87	75	71
49	39	58	41	44	53	57	61	62	56	51	81	58	66	54	63	54	62	56	60	48	71	60	64	66	65	68	71	44	59	53	55	69	62	62	55	58	62	54	59	62	56	49	53	44	62	47	50	61	60	55	59	50	57	61	54	69	71	63	53	57	46	56	54	62	60	61	62	63	50	47	49	74	64	51	66	63	44	53	54	45	49	51	36	59	53	54	46	58	56	58	59	55	55	54	54	49	60	52	69
0	0	0	0	0	0	0	0	0	0	0	0	0	0	0	0	0	0	0	0	0	0	0	0	0	0	0	0	0	0	0	0	0	0	0	0	0	0	0	0	0	0	0	0	0	0	0	0	0	0	0	0	0	0	0	0	0	0	0	0	0	0	0	0	0	0	0	0	0	0	0	0	0	0	0	0	0	0	0	0	0	0	0	0	0	0	0	0	0	0	0	0	0	0	0	0	0	0	0	0
0	0	0	0	0	0	0	0	0	0	0	0	0	0	0	0	0	0	0	0	0	0	0	0	0	0	0	0	0	0	0	0	0	0	0	0	0	0	0	0	0	0	0	0	0	0	0	0	0	0	0	0	0	0	0	0	0	0	0	0	0	0	0	0	0	0	0	0	0	0	0	0	0	0	0	0	0	0	0	0	0	0	0	0	0	0	0	0	0	0	0	0	0	0	0	0	0	0	0	0
0	0	0	0	0	0	0	0	0	0	0	0	0	0	0	0	0	0	0	0	0	0	0	0	0	0	0	0	0	0	0	0	0	0	0	0	0	0	0	0	0	0	0	0	0	0	0	0	0	0	0	0	0	0	0	0	0	0	0	0	0	0	0	0	0	0	0	0	0	0	0	0	0	0	0	0	0	0	0	0	0	0	0	0	0	0	0	0	0	0	0	0	0	0	0	0	0	0	0	0
0	0	0	0	0	0	0	0	0	0	0	0	0	0	0	0	0	0	0	0	0	0	0	0	0	0	0	0	0	0	0	0	0	0	0	0	0	0	0	0	0	0	0	0	0	0	0	0	0	0	0	0	0	0	0	0	0	0	0	0	0	0	0	0	0	0	0	0	0	0	0	0	0	0	0	0	0	0	0	0	0	0	0	0	0	0	0	0	0	0	0	0	0	0	0	0	0	0	0	0
54	56	49	53	56	62	62	55	65	64	56	65	61	69	70	51	52	52	61	56	61	65	49	71	64	68	57	57	52	49	59	56	63	64	50	56	52	50	52	57	65	49	62	52	54	48	48	63	51	49	58	53	48	40	50	50	55	63	63	63	61	44	60	55	49	62	53	47	46	63	57	63	62	69	60	58	52	53	59	56	61	39	53	59	67	77	52	49	48	47	58	52	68	49	55	67	68	47	50	50
