88	88	50	56	59	49	76	72	93	77	75	71	63	95	80	84	92	88	77	106	94	76	65	65	64	61	69	75	43	65	72	73	84	86	73	80	60	44	50	48	51	51	60	68	67	70	37	50	47	73	71	80	74	63	82	76	88	97	85	63	70	77	74	66	68	55	56	35	57	59	80	54	54	76	77	83	63	62	60	64	57	80	55	45	61	72	75	54	56	69	66	57	76	65	69	93	71	62	81	81
59	65	52	47	56	43	59	53	54	55	53	64	45	71	53	53	41	63	50	48	50	66	66	65	61	66	48	56	62	52	58	47	42	65	45	34	41	54	73	66	59	65	64	65	62	59	67	75	63	47	55	49	61	50	55	47	48	56	53	60	62	57	44	53	60	62	67	66	48	61	64	60	41	47	58	53	51	43	62	49	52	58	69	62	50	73	49	64	68	62	65	51	63	55	54	50	52	57	50	50
0	0	0	0	0	0	0	0	0	0	0	0	0	0	0	0	0	0	0	0	0	0	0	0	0	0	0	0	0	0	0	0	0	0	0	0	0	0	0	0	0	0	0	0	0	0	0	0	0	0	0	0	0	0	0	0	0	0	0	0	0	0	0	0	0	0	0	0	0	0	0	0	0	0	0	0	0	0	0	0	0	0	0	0	0	0	0	0	0	0	0	0	0	0	0	0	0	0	0	0
0	0	0	0	0	0	0	0	0	0	0	0	0	0	0	0	0	0	0	0	0	0	0	0	0	0	0	0	0	0	0	0	0	0	0	0	0	0	0	0	0	0	0	0	0	0	0	0	0	0	0	0	0	0	0	0	0	0	0	0	0	0	0	0	0	0	0	0	0	0	0	0	0	0	0	0	0	0	0	0	0	0	0	0	0	0	0	0	0	0	0	0	0	0	0	0	0	0	0	0
0	0	0	0	0	0	0	0	0	0	0	0	0	0	0	0	0	0	0	0	0	0	0	0	0	0	0	0	0	0	0	0	0	0	0	0	0	0	0	0	0	0	0	0	0	0	0	0	0	0	0	0	0	0	0	0	0	0	0	0	0	0	0	0	0	0	0	0	0	0	0	0	0	0	0	0	0	0	0	0	0	0	0	0	0	0	0	0	0	0	0	0	0	0	0	0	0	0	0	0
0	0	0	0	0	0	0	0	0	0	0	0	0	0	0	0	0	0	0	0	0	0	0	0	0	0	0	0	0	0	0	0	0	0	0	0	0	0	0	0	0	0	0	0	0	0	0	0	0	0	0	0	0	0	0	0	0	0	0	0	0	0	0	0	0	0	0	0	0	0	0	0	0	0	0	0	0	0	0	0	0	0	0	0	0	0	0	0	0	0	0	0	0	0	0	0	0	0	0	0
40	54	44	51	49	58	56	54	36	64	65	55	52	58	44	49	52	50	64	66	49	55	58	54	67	55	44	63	69	51	63	60	48	42	47	43	57	57	58	57	63	47	81	63	47	66	71	66	66	44	59	58	52	52	51	51	43	49	57	50	54	51	47	44	55	51	61	70	57	64	58	49	43	56	44	47	57	54	43	58	58	50	87	61	63	62	61	61	52	55	70	72	66	48	69	55	51	55	43	53
