88	84	68	85	74	68	68	55	66	52	72	56	79	67	55	63	83	51	61	62	60	57	86	68	72	60	72	61	57	54	71	69	88	88	46	77	61	56	65	75	68	70	73	55	54	64	54	49	48	69	83	75	70	97	70	86	63	76	86	65	73	80	64	66	82	79	66	71	63	74	74	59	57	65	70	63	57	65	84	77	94	77	74	65	74	84	66	78	61	61	65	71	80	86	72	61	67	84	71	102
48	54	46	54	62	50	47	40	73	72	53	52	51	60	44	64	61	68	60	80	47	56	47	56	55	48	49	54	42	67	50	59	55	48	48	53	70	46	51	54	45	60	58	61	56	51	50	53	59	69	48	51	47	49	48	52	76	48	63	46	45	54	40	39	48	54	57	48	54	56	52	70	71	63	34	43	47	46	46	46	43	56	54	49	40	54	63	54	55	59	39	62	54	41	60	58	56	43	52	46
0	0	0	0	0	0	0	0	0	0	0	0	0	0	0	0	0	0	0	0	0	0	0	0	0	0	0	0	0	0	0	0	0	0	0	0	0	0	0	0	0	0	0	0	0	0	0	0	0	0	0	0	0	0	0	0	0	0	0	0	0	0	0	0	0	0	0	0	0	0	0	0	0	0	0	0	0	0	0	0	0	0	0	0	0	0	0	0	0	0	0	0	0	0	0	0	0	0	0	0
0	0	0	0	0	0	0	0	0	0	0	0	0	0	0	0	0	0	0	0	0	0	0	0	0	0	0	0	0	0	0	0	0	0	0	0	0	0	0	0	0	0	0	0	0	0	0	0	0	0	0	0	0	0	0	0	0	0	0	0	0	0	0	0	0	0	0	0	0	0	0	0	0	0	0	0	0	0	0	0	0	0	0	0	0	0	0	0	0	0	0	0	0	0	0	0	0	0	0	0
0	0	0	0	0	0	0	0	0	0	0	0	0	0	0	0	0	0	0	0	0	0	0	0	0	0	0	0	0	0	0	0	0	0	0	0	0	0	0	0	0	0	0	0	0	0	0	0	0	0	0	0	0	0	0	0	0	0	0	0	0	0	0	0	0	0	0	0	0	0	0	0	0	0	0	0	0	0	0	0	0	0	0	0	0	0	0	0	0	0	0	0	0	0	0	0	0	0	0	0
0	0	0	0	0	0	0	0	0	0	0	0	0	0	0	0	0	0	0	0	0	0	0	0	0	0	0	0	0	0	0	0	0	0	0	0	0	0	0	0	0	0	0	0	0	0	0	0	0	0	0	0	0	0	0	0	0	0	0	0	0	0	0	0	0	0	0	0	0	0	0	0	0	0	0	0	0	0	0	0	0	0	0	0	0	0	0	0	0	0	0	0	0	0	0	0	0	0	0	0
48	50	62	63	59	65	49	62	56	55	57	53	56	62	68	64	62	59	61	68	59	56	64	58	51	54	60	51	52	68	50	47	59	59	49	58	58	49	57	58	50	66	56	65	64	48	51	48	63	53	47	40	53	50	42	60	56	53	36	56	54	53	37	45	56	34	49	44	59	65	58	59	59	48	33	39	48	54	66	67	74	50	54	58	48	56	59	62	45	69	51	48	59	47	58	55	45	53	54	49
