54	54	51	68	38	76	74	68	60	70	74	88	77	89	85	74	85	91	78	85	56	73	58	59	63	67	75	62	76	91	82	75	62	64	73	76	75	75	61	80	79	51	60	72	60	47	61	64	68	68	82	78	63	88	71	63	85	86	87	89	85	86	65	69	43	71	66	57	43	64	81	68	88	78	52	62	56	68	65	78	80	68	78	58	60	62	71	76	65	77	57	69	59	51	45	59	57	50	61	57
59	64	61	61	69	63	70	54	58	60	52	52	59	49	46	65	42	61	47	51	37	55	63	63	48	37	48	59	43	52	59	60	65	54	56	55	37	45	40	34	50	46	53	59	49	69	51	52	51	64	56	52	72	36	57	59	50	51	50	51	51	50	55	46	55	46	48	64	50	40	44	64	54	61	52	52	73	47	61	43	59	44	67	58	47	48	57	45	49	47	56	61	64	62	67	67	69	54	68	55
0	0	0	0	0	0	0	0	0	0	0	0	0	0	0	0	0	0	0	0	0	0	0	0	0	0	0	0	0	0	0	0	0	0	0	0	0	0	0	0	0	0	0	0	0	0	0	0	0	0	0	0	0	0	0	0	0	0	0	0	0	0	0	0	0	0	0	0	0	0	0	0	0	0	0	0	0	0	0	0	0	0	0	0	0	0	0	0	0	0	0	0	0	0	0	0	0	0	0	0
0	0	0	0	0	0	0	0	0	0	0	0	0	0	0	0	0	0	0	0	0	0	0	0	0	0	0	0	0	0	0	0	0	0	0	0	0	0	0	0	0	0	0	0	0	0	0	0	0	0	0	0	0	0	0	0	0	0	0	0	0	0	0	0	0	0	0	0	0	0	0	0	0	0	0	0	0	0	0	0	0	0	0	0	0	0	0	0	0	0	0	0	0	0	0	0	0	0	0	0
0	0	0	0	0	0	0	0	0	0	0	0	0	0	0	0	0	0	0	0	0	0	0	0	0	0	0	0	0	0	0	0	0	0	0	0	0	0	0	0	0	0	0	0	0	0	0	0	0	0	0	0	0	0	0	0	0	0	0	0	0	0	0	0	0	0	0	0	0	0	0	0	0	0	0	0	0	0	0	0	0	0	0	0	0	0	0	0	0	0	0	0	0	0	0	0	0	0	0	0
0	0	0	0	0	0	0	0	0	0	0	0	0	0	0	0	0	0	0	0	0	0	0	0	0	0	0	0	0	0	0	0	0	0	0	0	0	0	0	0	0	0	0	0	0	0	0	0	0	0	0	0	0	0	0	0	0	0	0	0	0	0	0	0	0	0	0	0	0	0	0	0	0	0	0	0	0	0	0	0	0	0	0	0	0	0	0	0	0	0	0	0	0	0	0	0	0	0	0	0
59	56	61	62	46	56	45	68	54	61	47	56	49	56	64	56	63	57	48	51	42	42	57	47	43	42	53	48	56	61	39	49	55	60	56	58	50	50	57	62	64	65	55	50	55	52	63	51	60	55	61	56	49	62	60	48	53	43	55	60	44	66	46	50	59	46	58	55	52	45	58	48	55	41	48	47	62	68	46	76	60	48	48	56	56	52	56	57	53	63	71	70	52	72	60	59	59	74	65	68
