35	29	44	41	40	33	46	26	33	38	44	31	53	37	56	39	37	39	36	41	56	37	43	40	50	36	33	35	28	46	41	36	39	32	38	40	38	51	48	39	35	39	43	40	44	44	39	28	38	33	46	39	29	25	41	44	50	45	50	47	35	32	49	37	47	43	49	48	54	46	54	50	49	50	40	39	26	39	40	32	27	44	45	49	60	50	37	32	48	43	58	55	43	50	52	57	44	49	33	40
56	52	50	64	43	59	60	61	52	59	68	62	55	60	49	60	61	44	49	41	43	60	54	55	38	56	64	55	60	60	47	46	63	61	54	53	42	52	46	55	54	56	48	54	58	60	47	46	52	44	53	60	52	57	54	43	48	49	59	48	44	47	46	52	55	49	39	38	45	44	45	42	33	48	59	46	48	46	50	49	58	50	47	40	36	55	48	38	49	52	47	55	50	66	46	41	54	53	54	44
0	0	0	0	0	0	0	0	0	0	0	0	0	0	0	0	0	0	0	0	0	0	0	0	0	0	0	0	0	0	0	0	0	0	0	0	0	0	0	0	0	0	0	0	0	0	0	0	0	0	0	0	0	0	0	0	0	0	0	0	0	0	0	0	0	0	0	0	0	0	0	0	0	0	0	0	0	0	0	0	0	0	0	0	0	0	0	0	0	0	0	0	0	0	0	0	0	0	0	0
0	0	0	0	0	0	0	0	0	0	0	0	0	0	0	0	0	0	0	0	0	0	0	0	0	0	0	0	0	0	0	0	0	0	0	0	0	0	0	0	0	0	0	0	0	0	0	0	0	0	0	0	0	0	0	0	0	0	0	0	0	0	0	0	0	0	0	0	0	0	0	0	0	0	0	0	0	0	0	0	0	0	0	0	0	0	0	0	0	0	0	0	0	0	0	0	0	0	0	0
0	0	0	0	0	0	0	0	0	0	0	0	0	0	0	0	0	0	0	0	0	0	0	0	0	0	0	0	0	0	0	0	0	0	0	0	0	0	0	0	0	0	0	0	0	0	0	0	0	0	0	0	0	0	0	0	0	0	0	0	0	0	0	0	0	0	0	0	0	0	0	0	0	0	0	0	0	0	0	0	0	0	0	0	0	0	0	0	0	0	0	0	0	0	0	0	0	0	0	0
0	0	0	0	0	0	0	0	0	0	0	0	0	0	0	0	0	0	0	0	0	0	0	0	0	0	0	0	0	0	0	0	0	0	0	0	0	0	0	0	0	0	0	0	0	0	0	0	0	0	0	0	0	0	0	0	0	0	0	0	0	0	0	0	0	0	0	0	0	0	0	0	0	0	0	0	0	0	0	0	0	0	0	0	0	0	0	0	0	0	0	0	0	0	0	0	0	0	0	0
56	62	46	56	54	57	50	52	45	53	46	43	35	39	43	56	64	54	35	34	41	60	43	52	62	50	53	64	60	52	47	55	54	57	46	57	67	50	39	46	57	44	51	58	43	51	45	59	54	55	45	63	57	47	54	62	52	44	53	56	52	43	50	46	61	51	42	36	43	47	48	46	46	64	41	31	40	48	61	50	56	40	46	32	56	45	56	57	38	46	50	51	56	52	36	57	46	66	50	60
26	20	22	21	25	30	27	23	25	24	23	25	24	23	23	26	21	27	31	38	29	24	30	19	31	27	18	16	27	22	29	21	26	24	27	22	27	25	34	27	34	29	22	20	26	30	24	31	23	22	33	30	29	25	18	35	25	21	21	26	32	34	31	20	18	33	29	38	25	26	23	25	36	24	34	34	34	30	32	26	37	38	31	32	22	25	33	33	19	23	26	19	15	23	22	27	25	19	26	32
